"all";"male";"female";"year.ref";"age.min";"age.max";"year"
382170;196801;185369;2010;0;4;2010
381376;196406;184970;2010;5;9;2010
417675;214858;202817;2010;10;14;2010
454904;233589;221315;2010;15;19;2010
470871;237898;232973;2010;20;24;2010
507179;254043;253136;2010;25;29;2010
525183;261907;263276;2010;30;34;2010
570943;286440;284503;2010;35;39;2010
642499;323426;319073;2010;40;44;2010
634893;321162;313731;2010;45;49;2010
550052;278357;271695;2010;50;54;2010
481840;240698;241142;2010;55;59;2010
457530;226156;231374;2010;60;64;2010
383053;184254;198799;2010;65;69;2010
300300;137629;162671;2010;70;74;2010
253734;108634;145100;2010;75;79;2010
191585;72813;118772;2010;80;84;2010
180019;55495;124524;2010;85;NA;2010
390629;200758;189871;2011;0;4;2011
383054;196612;186442;2011;5;9;2011
417133;213936;203197;2011;10;14;2011
451619;231379;220240;2011;15;19;2011
484981;246153;238828;2011;20;24;2011
521352;263516;257836;2011;25;29;2011
534808;268638;266170;2011;30;34;2011
558919;280086;278833;2011;35;39;2011
634072;318088;315984;2011;40;44;2011
650915;329746;321169;2011;45;49;2011
566311;286684;279627;2011;50;54;2011
486836;243474;243362;2011;55;59;2011
459811;226815;232996;2011;60;64;2011
397242;191911;205331;2011;65;69;2011
303448;139108;164340;2011;70;74;2011
256058;110430;145628;2011;75;79;2011
194379;74620;119759;2011;80;84;2011
178567;55472;123095;2011;85;NA;2011
398095;204560;193535;2012;0;4;2012
385863;197991;187872;2012;5;9;2012
410691;210863;199828;2012;10;14;2012
447894;229475;218419;2012;15;19;2012
491602;249670;241932;2012;20;24;2012
527804;266662;261142;2012;25;29;2012
546818;275365;271453;2012;30;34;2012
553890;277747;276143;2012;35;39;2012
624940;313186;311754;2012;40;44;2012
662507;335852;326655;2012;45;49;2012
582357;294257;288100;2012;50;54;2012
499696;250826;248870;2012;55;59;2012
457353;225701;231652;2012;60;64;2012
411009;199000;212009;2012;65;69;2012
312450;144041;168409;2012;70;74;2012
259407;112530;146877;2012;75;79;2012
197484;76742;120742;2012;80;84;2012
184802;57785;127017;2012;85;NA;2012
404449;208107;196342;2013;0;4;2013
390062;199958;190104;2013;5;9;2013
406092;208624;197468;2013;10;14;2013
442704;226916;215788;2013;15;19;2013
498088;253231;244857;2013;20;24;2013
532258;269140;263118;2013;25;29;2013
559161;281961;277200;2013;30;34;2013
554086;278189;275897;2013;35;39;2013
615491;309069;306422;2013;40;44;2013
667709;338072;329637;2013;45;49;2013
599998;303299;296699;2013;50;54;2013
512120;257714;254406;2013;55;59;2013
458224;225989;232235;2013;60;64;2013
420165;203539;216626;2013;65;69;2013
326356;151509;174847;2013;70;74;2013
261434;114184;147250;2013;75;79;2013
201444;79382;122062;2013;80;84;2013
189219;59641;129578;2013;85;NA;2013
411610;211646;199964;2014;0;4;2014
397741;204230;193511;2014;5;9;2014
402926;206846;196080;2014;10;14;2014
441234;226301;214933;2014;15;19;2014
498961;253574;245387;2014;20;24;2014
543207;274522;268685;2014;25;29;2014
570734;288145;282589;2014;30;34;2014
559571;281336;278235;2014;35;39;2014
605311;304469;300842;2014;40;44;2014
668254;338087;330167;2014;45;49;2014
621473;314108;307365;2014;50;54;2014
527148;266125;261023;2014;55;59;2014
458714;226250;232464;2014;60;64;2014
427426;207158;220268;2014;65;69;2014
341072;159179;181893;2014;70;74;2014
265528;116891;148637;2014;75;79;2014
204553;81364;123189;2014;80;84;2014
194168;61860;132308;2014;85;NA;2014
418295;214938;203357;2015;0;4;2015
404759;208148;196611;2015;5;9;2015
401927;206229;195698;2015;10;14;2015
438771;224978;213793;2015;15;19;2015
498313;253521;244792;2015;20;24;2015
551444;278301;273143;2015;25;29;2015
582448;294606;287842;2015;30;34;2015
566720;285134;281586;2015;35;39;2015
597760;301314;296446;2015;40;44;2015
662100;334355;327745;2015;45;49;2015
642615;325346;317269;2015;50;54;2015
543463;274509;268954;2015;55;59;2015
463486;228800;234686;2015;60;64;2015
430556;208469;222087;2015;65;69;2015
356726;167479;189247;2015;70;74;2015
269582;119304;150278;2015;75;79;2015
208501;84090;124411;2015;80;84;2015
200200;64359;135841;2015;85;NA;2015
423031;217657;205374;2016;0;4;2016
413257;212219;201038;2016;5;9;2016
400504;205372;195132;2016;10;14;2016
438711;225456;213255;2016;15;19;2016
496048;252697;243351;2016;20;24;2016
560587;283314;277273;2016;25;29;2016
589284;297613;291671;2016;30;34;2016
579210;292170;287040;2016;35;39;2016
590167;297391;292776;2016;40;44;2016
654245;329701;324544;2016;45;49;2016
657774;333462;324312;2016;50;54;2016
560277;282913;277364;2016;55;59;2016
468979;231880;237099;2016;60;64;2016
433593;209673;223920;2016;65;69;2016
371249;175474;195775;2016;70;74;2016
273343;121302;152041;2016;75;79;2016
211503;86403;125100;2016;80;84;2016
205364;66774;138590;2016;85;NA;2016
430115;221304;208811;2017;0;4;2017
420456;215898;204558;2017;5;9;2017
404420;207439;196981;2017;10;14;2017
436475;225978;210497;2017;15;19;2017
495535;254086;241449;2017;20;24;2017
568581;288343;280238;2017;25;29;2017
596100;301290;294810;2017;30;34;2017
590339;298142;292197;2017;35;39;2017
584230;294236;289994;2017;40;44;2017
644679;324274;320405;2017;45;49;2017
669041;339192;329849;2017;50;54;2017
575812;290114;285698;2017;55;59;2017
480708;238531;242177;2017;60;64;2017
430368;208092;222276;2017;65;69;2017
384240;182193;202047;2017;70;74;2017
281899;126025;155874;2017;75;79;2017
214971;88581;126390;2017;80;84;2017
211581;69719;141862;2017;85;NA;2017
433743;222893;210850;2018;0;4;2018
426484;219276;207208;2018;5;9;2018
408828;209592;199236;2018;10;14;2018
431439;223310;208129;2018;15;19;2018
488709;251439;237270;2018;20;24;2018
572817;290366;282451;2018;25;29;2018
598895;302605;296290;2018;30;34;2018
600727;303314;297413;2018;35;39;2018
582171;292806;289365;2018;40;44;2018
633596;318687;314909;2018;45;49;2018
673096;340498;332598;2018;50;54;2018
591887;298232;293655;2018;55;59;2018
491373;244430;246943;2018;60;64;2018
429492;207401;222091;2018;65;69;2018
392361;186071;206290;2018;70;74;2018
294176;132535;161641;2018;75;79;2018
217197;90418;126779;2018;80;84;2018
217139;72561;144578;2018;85;NA;2018
437880;224752;213128;2019;0;4;2019
430304;221007;209297;2019;5;9;2019
415562;213495;202067;2019;10;14;2019
425712;219776;205936;2019;15;19;2019
483445;249100;234345;2019;20;24;2019
569288;288954;280334;2019;25;29;2019
606490;306152;300338;2019;30;34;2019
608706;307401;301305;2019;35;39;2019
583783;293717;290066;2019;40;44;2019
620649;311949;308700;2019;45;49;2019
671146;338894;332252;2019;50;54;2019
610732;307700;303032;2019;55;59;2019
503529;251173;252356;2019;60;64;2019
427996;206561;221435;2019;65;69;2019
398116;188848;209268;2019;70;74;2019
307537;139426;168111;2019;75;79;2019
220832;92810;128022;2019;80;84;2019
222820;75406;147414;2019;85;NA;2019
437695;224543;213152;2020;0;4;2020
435348;223597;211751;2020;5;9;2020
421875;217016;204859;2020;10;14;2020
422280;217556;204724;2020;15;19;2020
479503;247227;232276;2020;20;24;2020
565847;287649;278198;2020;25;29;2020
612081;309022;303059;2020;30;34;2020
617095;311827;305268;2020;35;39;2020
588156;295717;292439;2020;40;44;2020
610169;306832;303337;2020;45;49;2020
662817;333884;328933;2020;50;54;2020
630020;317676;312344;2020;55;59;2020
517347;258313;259034;2020;60;64;2020
430612;207844;222768;2020;65;69;2020
400091;189694;210397;2020;70;74;2020
321427;146689;174738;2020;75;79;2020
224513;94978;129535;2020;80;84;2020
229157;78799;150358;2020;85;NA;2020
437118;224268;212850;2021;0;4;2021
439685;226409;213276;2021;5;9;2021
429468;220562;208906;2021;10;14;2021
420030;216228;203802;2021;15;19;2021
478181;247027;231154;2021;20;24;2021
559953;284900;275053;2021;25;29;2021
620459;313683;306776;2021;30;34;2021
622771;314591;308180;2021;35;39;2021
599618;301811;297807;2021;40;44;2021
601859;302514;299345;2021;45;49;2021
654609;328949;325660;2021;50;54;2021
644500;325419;319081;2021;55;59;2021
532379;265775;266604;2021;60;64;2021
434914;210196;224718;2021;65;69;2021
402215;190316;211899;2021;70;74;2021
334252;153639;180613;2021;75;79;2021
227086;96134;130952;2021;80;84;2021
231203;80178;151025;2021;85;NA;2021
438570;225061;213509;2022;0;4;2022
445334;229032;216302;2022;5;9;2022
435738;223644;212094;2022;10;14;2022
423256;217993;205263;2022;15;19;2022
471602;243938;227664;2022;20;24;2022
556130;283361;272769;2022;25;29;2022
626424;317388;309036;2022;30;34;2022
628533;317413;311120;2022;35;39;2022
610154;307604;302550;2022;40;44;2022
595385;299093;296292;2022;45;49;2022
644683;323358;321325;2022;50;54;2022
655329;330990;324339;2022;55;59;2022
546334;272182;274152;2022;60;64;2022
444883;215654;229229;2022;65;69;2022
399048;188632;210416;2022;70;74;2022
345401;159286;186115;2022;75;79;2022
235109;100419;134690;2022;80;84;2022
236878;83155;153723;2022;85;NA;2022
434565;223218;211347;2023;0;4;2023
449428;230782;218646;2023;5;9;2023
442768;227505;215263;2023;10;14;2023
428452;220980;207472;2023;15;19;2023
468092;242325;225767;2023;20;24;2023
555111;283824;271287;2023;25;29;2023
634972;322108;312864;2023;30;34;2023
634985;321434;313551;2023;35;39;2023
622962;314081;308881;2023;40;44;2023
595240;299019;296221;2023;45;49;2023
635218;318681;316537;2023;50;54;2023
659955;332994;326961;2023;55;59;2023
562014;279960;282054;2023;60;64;2023
454454;220839;233615;2023;65;69;2023
398769;188390;210379;2023;70;74;2023
352754;162639;190115;2023;75;79;2023
245490;105858;139632;2023;80;84;2023
240156;85316;154840;2023;85;NA;2023
430068;220883;209185;2024;0;4;2024
459966;236158;223808;2024;5;9;2024
453359;232739;220620;2024;10;14;2024
445047;231193;213854;2024;15;19;2024
470327;243617;226710;2024;20;24;2024
561671;287459;274212;2024;25;29;2024
642297;325940;316357;2024;30;34;2024
653854;330174;323680;2024;35;39;2024
640044;322037;318007;2024;40;44;2024
603554;302745;300809;2024;45;49;2024
627250;314058;313192;2024;50;54;2024
661597;332801;328796;2024;55;59;2024
582938;289741;293197;2024;60;64;2024
468069;227650;240419;2024;65;69;2024
399748;188593;211155;2024;70;74;2024
358912;165390;193522;2024;75;79;2024
257601;111838;145763;2024;80;84;2024
245956;88516;157440;2024;85;NA;2024
