"all";"male";"female";"year.ref";"age.min";"age.max";"year"
326067;167172;158895;2010;0;4;2010
329874;168751;161123;2010;5;9;2010
345377;177120;168257;2010;10;14;2010
350928;179957;170971;2010;15;19;2010
326535;166418;160117;2010;20;24;2010
310970;155957;155013;2010;25;29;2010
353369;177078;176291;2010;30;34;2010
387393;194779;192614;2010;35;39;2010
414573;210336;204237;2010;40;44;2010
399835;202547;197288;2010;45;49;2010
364297;183347;180950;2010;50;54;2010
350004;174619;175385;2010;55;59;2010
372657;185458;187199;2010;60;64;2010
298841;146029;152812;2010;65;69;2010
216868;102280;114588;2010;70;74;2010
159640;70678;88962;2010;75;79;2010
117547;47218;70329;2010;80;84;2010
109963;33542;76421;2010;85;NA;2010
325495;167084;158411;2011;0;4;2011
327867;167616;160251;2011;5;9;2011
341725;175007;166718;2011;10;14;2011
356466;182827;173639;2011;15;19;2011
337459;171997;165462;2011;20;24;2011
311548;156548;155000;2011;25;29;2011
342593;171742;170851;2011;30;34;2011
389788;195459;194329;2011;35;39;2011
403306;204243;199063;2011;40;44;2011
409904;207446;202458;2011;45;49;2011
367225;184704;182521;2011;50;54;2011
349543;174659;174884;2011;55;59;2011
363928;180466;183462;2011;60;64;2011
318797;156375;162422;2011;65;69;2011
223846;105875;117971;2011;70;74;2011
162633;72547;90086;2011;75;79;2011
117189;47614;69575;2011;80;84;2011
111316;34373;76943;2011;85;NA;2011
319203;163640;155563;2012;0;4;2012
328548;168229;160319;2012;5;9;2012
338707;173268;165439;2012;10;14;2012
359125;184265;174860;2012;15;19;2012
347475;176821;170654;2012;20;24;2012
316190;159427;156763;2012;25;29;2012
333621;167038;166583;2012;30;34;2012
382415;191388;191027;2012;35;39;2012
392184;198283;193901;2012;40;44;2012
422591;213892;208699;2012;45;49;2012
369277;185721;183556;2012;50;54;2012
352243;175856;176387;2012;55;59;2012
350853;173745;177108;2012;60;64;2012
339865;167090;172775;2012;65;69;2012
230590;109338;121252;2012;70;74;2012
167266;75138;92128;2012;75;79;2012
117322;48153;69169;2012;80;84;2012
113041;35484;77557;2012;85;NA;2012
312956;160671;152285;2013;0;4;2013
329520;168595;160925;2013;5;9;2013
335120;171454;163666;2013;10;14;2013
358224;183817;174407;2013;15;19;2013
359625;183050;176575;2013;20;24;2013
322222;162747;159475;2013;25;29;2013
328063;164689;163374;2013;30;34;2013
371971;186128;185843;2013;35;39;2013
388543;195850;192693;2013;40;44;2013
427351;216186;211165;2013;45;49;2013
374370;188334;186036;2013;50;54;2013
353381;176463;176918;2013;55;59;2013
341481;168916;172565;2013;60;64;2013
352035;173062;178973;2013;65;69;2013
241994;115434;126560;2013;70;74;2013
173089;78170;94919;2013;75;79;2013
118170;48916;69254;2013;80;84;2013
114513;36370;78143;2013;85;NA;2013
303782;155792;147990;2014;0;4;2014
331146;169735;161411;2014;5;9;2014
333742;170628;163114;2014;10;14;2014
356746;183030;173716;2014;15;19;2014
368274;187595;180679;2014;20;24;2014
333707;169199;164508;2014;25;29;2014
321890;161762;160128;2014;30;34;2014
365935;183201;182734;2014;35;39;2014
387330;194651;192679;2014;40;44;2014
422425;213715;208710;2014;45;49;2014
383496;192922;190574;2014;50;54;2014
354046;176808;177238;2014;55;59;2014
337982;167057;170925;2014;60;64;2014
356312;175249;181063;2014;65;69;2014
255367;121985;133382;2014;70;74;2014
180164;81870;98294;2014;75;79;2014
119026;49641;69385;2014;80;84;2014
115865;37439;78426;2014;85;NA;2014
298368;153001;145367;2015;0;4;2015
330947;169791;161156;2015;5;9;2015
333332;170510;162822;2015;10;14;2015
352904;181089;171815;2015;15;19;2015
377040;192234;184806;2015;20;24;2015
346358;176161;170197;2015;25;29;2015
319869;161526;158343;2015;30;34;2015
358865;180041;178824;2015;35;39;2015
389604;195490;194114;2015;40;44;2015
413604;209022;204582;2015;45;49;2015
395097;199100;195997;2015;50;54;2015
355781;177815;177966;2015;55;59;2015
336817;166416;170401;2015;60;64;2015
351880;172808;179072;2015;65;69;2015
273446;130931;142515;2015;70;74;2015
186394;85272;101122;2015;75;79;2015
121930;51232;70698;2015;80;84;2015
117479;38575;78904;2015;85;NA;2015
294748;151130;143618;2016;0;4;2016
332625;170924;161701;2016;5;9;2016
332901;170295;162606;2016;10;14;2016
350964;179968;170996;2016;15;19;2016
386749;197598;189151;2016;20;24;2016
361983;184872;177111;2016;25;29;2016
323168;163937;159231;2016;30;34;2016
350425;176324;174101;2016;35;39;2016
393520;197269;196251;2016;40;44;2016
403639;203825;199814;2016;45;49;2016
405774;204442;201332;2016;50;54;2016
359474;179791;179683;2016;55;59;2016
336859;166766;170093;2016;60;64;2016
344348;168573;175775;2016;65;69;2016
292443;140598;151845;2016;70;74;2016
193873;89001;104872;2016;75;79;2016
125369;53210;72159;2016;80;84;2016
118389;39364;79025;2016;85;NA;2016
298063;153180;144883;2017;0;4;2017
328443;168476;159967;2017;5;9;2017
335062;171661;163401;2017;10;14;2017
349350;178989;170361;2017;15;19;2017
391322;200134;191188;2017;20;24;2017
374117;190982;183135;2017;25;29;2017
330546;168307;162239;2017;30;34;2017
343423;172682;170741;2017;35;39;2017
387871;194331;193540;2017;40;44;2017
393841;198807;195034;2017;45;49;2017
419493;211581;207912;2017;50;54;2017
362210;181180;181030;2017;55;59;2017
339856;168133;171723;2017;60;64;2017
332296;162414;169882;2017;65;69;2017
312288;150619;161669;2017;70;74;2017
200867;92600;108267;2017;75;79;2017
130127;55736;74391;2017;80;84;2017
119594;40366;79228;2017;85;NA;2017
300798;154359;146439;2018;0;4;2018
322681;165691;156990;2018;5;9;2018
337091;172571;164520;2018;10;14;2018
345980;177279;168701;2018;15;19;2018
391572;199939;191633;2018;20;24;2018
386777;197346;189431;2018;25;29;2018
337657;172227;165430;2018;30;34;2018
339008;170855;168153;2018;35;39;2018
378255;189519;188736;2018;40;44;2018
391089;196926;194163;2018;45;49;2018
425011;214363;210648;2018;50;54;2018
367613;183854;183759;2018;55;59;2018
341595;169081;172514;2018;60;64;2018
323628;158023;165605;2018;65;69;2018
324093;156330;167763;2018;70;74;2018
211648;98169;113479;2018;75;79;2018
135926;58646;77280;2018;80;84;2018
120768;41295;79473;2018;85;NA;2018
304963;156694;148269;2019;0;4;2019
313253;160513;152740;2019;5;9;2019
339254;173903;165351;2019;10;14;2019
344415;176274;168141;2019;15;19;2019
388990;198647;190343;2019;20;24;2019
394889;201431;193458;2019;25;29;2019
348274;177846;170428;2019;30;34;2019
332887;168058;164829;2019;35;39;2019
372565;186713;185852;2019;40;44;2019
390083;195838;194245;2019;45;49;2019
420781;212293;208488;2019;50;54;2019
376994;188671;188323;2019;55;59;2019
342670;169672;172998;2019;60;64;2019
320259;156271;163988;2019;65;69;2019
328265;158527;169738;2019;70;74;2019
223793;103902;119891;2019;75;79;2019
142088;61706;80382;2019;80;84;2019
121658;42114;79544;2019;85;NA;2019
307888;158286;149602;2020;0;4;2020
306601;157127;149474;2020;5;9;2020
338629;173744;164885;2020;10;14;2020
343282;175643;167639;2020;15;19;2020
381891;194954;186937;2020;20;24;2020
400810;204408;196402;2020;25;29;2020
358346;182835;175511;2020;30;34;2020
328462;165977;162485;2020;35;39;2020
364159;182485;181674;2020;40;44;2020
391889;196145;195744;2020;45;49;2020
411906;207533;204373;2020;50;54;2020
388538;194819;193719;2020;55;59;2020
344371;170661;173710;2020;60;64;2020
319275;155734;163541;2020;65;69;2020
324554;156463;168091;2020;70;74;2020
239836;111613;128223;2020;75;79;2020
147963;64756;83207;2020;80;84;2020
124363;43735;80628;2020;85;NA;2020
309850;159224;150626;2021;0;4;2021
300360;153879;146481;2021;5;9;2021
338574;173946;164628;2021;10;14;2021
341466;174603;166863;2021;15;19;2021
375904;191869;184035;2021;20;24;2021
402836;205404;197432;2021;25;29;2021
368467;188196;180271;2021;30;34;2021
328212;165978;162234;2021;35;39;2021
353820;177372;176448;2021;40;44;2021
395004;197261;197743;2021;45;49;2021
401646;201937;199709;2021;50;54;2021
399520;200340;199180;2021;55;59;2021
348114;172631;175483;2021;60;64;2021
319469;156120;163349;2021;65;69;2021
317771;152599;165172;2021;70;74;2021
256926;120155;136771;2021;75;79;2021
154710;68012;86698;2021;80;84;2021
127396;45331;82065;2021;85;NA;2021
311412;159857;151555;2022;0;4;2022
301614;154975;146639;2022;5;9;2022
332805;170680;162125;2022;10;14;2022
343723;175842;167881;2022;15;19;2022
375447;191529;183918;2022;20;24;2022
406075;207455;198620;2022;25;29;2022
378954;193699;185255;2022;30;34;2022
334816;170080;164736;2022;35;39;2022
346545;173740;172805;2022;40;44;2022
389706;194573;195133;2022;45;49;2022
392510;197311;195199;2022;50;54;2022
413339;207510;205829;2022;55;59;2022
351258;174227;177031;2022;60;64;2022
322692;157562;165130;2022;65;69;2022
306526;146860;159666;2022;70;74;2022
274510;128834;145676;2022;75;79;2022
160839;70957;89882;2022;80;84;2022
130649;47224;83425;2022;85;NA;2022
310676;159630;151046;2023;0;4;2023
306909;157514;149395;2023;5;9;2023
329873;169294;160579;2023;10;14;2023
347923;177701;170222;2023;15;19;2023
375378;190967;184411;2023;20;24;2023
409553;208810;200743;2023;25;29;2023
395334;201451;193883;2023;30;34;2023
345726;175411;170315;2023;35;39;2023
345513;173243;172270;2023;40;44;2023
382173;190552;191621;2023;45;49;2023
391370;195969;195401;2023;50;54;2023
420559;210879;209680;2023;55;59;2023
358338;177665;180673;2023;60;64;2023
325352;158892;166460;2023;65;69;2023
298794;142877;155917;2023;70;74;2023
284851;133587;151264;2023;75;79;2023
169568;75269;94299;2023;80;84;2023
134764;49288;85476;2023;85;NA;2023
306638;157540;149098;2024;0;4;2024
311109;159866;151243;2024;5;9;2024
320521;164296;156225;2024;10;14;2024
350913;179755;171158;2024;15;19;2024
375678;190874;184804;2024;20;24;2024
409715;208974;200741;2024;25;29;2024
403882;205737;198145;2024;30;34;2024
357912;182255;175657;2024;35;39;2024
340314;170871;169443;2024;40;44;2024
377233;188230;189003;2024;45;49;2024
390931;195215;195716;2024;50;54;2024
416858;209042;207816;2024;55;59;2024
368091;182558;185533;2024;60;64;2024
327014;159785;167229;2024;65;69;2024
295938;141463;154475;2024;70;74;2024
288628;135370;153258;2024;75;79;2024
179602;79671;99931;2024;80;84;2024
140272;52189;88083;2024;85;NA;2024
