"all";"male";"female";"year.ref";"age.min";"age.max";"year"
2496690;1287318;1209372;2010;0;4;2010
2306649;1185938;1120711;2010;5;9;2010
2130454;1094596;1035858;2010;10;14;2010
2264335;1167074;1097261;2010;15;19;2010
2654032;1351381;1302651;2010;20;24;2010
3402286;1739467;1662819;2010;25;29;2010
4099015;2120014;1979001;2010;30;34;2010
3998273;2066006;1932267;2010;35;39;2010
3771058;1923379;1847679;2010;40;44;2010
3480003;1751653;1728350;2010;45;49;2010
3049954;1517996;1531958;2010;50;54;2010
2578223;1269787;1308436;2010;55;59;2010
2445247;1182525;1262722;2010;60;64;2010
2074945;986345;1088600;2010;65;69;2010
1738574;788678;949896;2010;70;74;2010
1737789;746369;991420;2010;75;79;2010
1243187;483876;759311;2010;80;84;2010
1015905;319870;696035;2010;85;NA;2010
2498449;1289348;1209101;2011;0;4;2011
2347840;1206431;1141409;2011;5;9;2011
2167410;1114535;1052875;2011;10;14;2011
2228086;1148567;1079519;2011;15;19;2011
2568267;1305493;1262774;2011;20;24;2011
3225923;1639319;1586604;2011;25;29;2011
4008886;2063851;1945035;2011;30;34;2011
4049367;2090009;1959358;2011;35;39;2011
3808223;1945445;1862778;2011;40;44;2011
3541523;1783445;1758078;2011;45;49;2011
3154523;1570932;1583591;2011;50;54;2011
2645892;1303616;1342276;2011;55;59;2011
2439790;1181936;1257854;2011;60;64;2011
2103623;1000844;1102779;2011;65;69;2011
1768965;806556;962409;2011;70;74;2011
1743238;752522;990716;2011;75;79;2011
1291221;505463;785758;2011;80;84;2011
1075948;341168;734780;2011;85;NA;2011
2476594;1278206;1198388;2012;0;4;2012
2397808;1233541;1164267;2012;5;9;2012
2202538;1133020;1069518;2012;10;14;2012
2199410;1132171;1067239;2012;15;19;2012
2503813;1272417;1231396;2012;20;24;2012
3065915;1547933;1517982;2012;25;29;2012
3869456;1981932;1887524;2012;30;34;2012
4091220;2107352;1983868;2012;35;39;2012
3846088;1965304;1880784;2012;40;44;2012
3610981;1820735;1790246;2012;45;49;2012
3238287;1613015;1625272;2012;50;54;2012
2720824;1340833;1379991;2012;55;59;2012
2467244;1197146;1270098;2012;60;64;2012
2192459;1042213;1150246;2012;65;69;2012
1710595;785328;925267;2012;70;74;2012
1760623;760328;1000295;2012;75;79;2012
1324628;523081;801547;2012;80;84;2012
1139736;364457;775279;2012;85;NA;2012
2419493;1248452;1171041;2013;0;4;2013
2437125;1254375;1182750;2013;5;9;2013
2223892;1144463;1079429;2013;10;14;2013
2165376;1114406;1050970;2013;15;19;2013
2445358;1242954;1202404;2013;20;24;2013
2903524;1459175;1444349;2013;25;29;2013
3688812;1876845;1811967;2013;30;34;2013
4078710;2095219;1983491;2013;35;39;2013
3854011;1968774;1885237;2013;40;44;2013
3666891;1848469;1818422;2013;45;49;2013
3283285;1635299;1647986;2013;50;54;2013
2793041;1374569;1418472;2013;55;59;2013
2500210;1214516;1285694;2013;60;64;2013
2266799;1077026;1189773;2013;65;69;2013
1711640;788496;923144;2013;70;74;2013
1724535;746141;978394;2013;75;79;2013
1368251;543365;824886;2013;80;84;2013
1181697;380682;801015;2013;85;NA;2013
2315647;1193987;1121660;2014;0;4;2014
2472955;1274351;1198604;2014;5;9;2014
2263254;1162796;1100458;2014;10;14;2014
2139358;1101709;1037649;2014;15;19;2014
2377665;1209860;1167805;2014;20;24;2014
2757946;1382795;1375151;2014;25;29;2014
3466353;1752778;1713575;2014;30;34;2014
4037967;2067176;1970791;2014;35;39;2014
3859317;1969683;1889634;2014;40;44;2014
3688374;1859118;1829256;2014;45;49;2014
3330740;1659100;1671640;2014;50;54;2014
2874610;1414555;1460055;2014;55;59;2014
2488882;1209758;1279124;2014;60;64;2014
2323532;1104565;1218967;2014;65;69;2014
1806428;834469;971959;2014;70;74;2014
1649395;714837;934558;2014;75;79;2014
1401403;559852;841551;2014;80;84;2014
1241918;403321;838597;2014;85;NA;2014
2249655;1159445;1090210;2015;0;4;2015
2477381;1277019;1200362;2015;5;9;2015
2301165;1183120;1118045;2015;10;14;2015
2149931;1106371;1043560;2015;15;19;2015
2322655;1183926;1138729;2015;20;24;2015
2652173;1329608;1322565;2015;25;29;2015
3285906;1655654;1630252;2015;30;34;2015
3958989;2020049;1938940;2015;35;39;2015
3891906;1985447;1906459;2015;40;44;2015
3688811;1860286;1828525;2015;45;49;2015
3405351;1696364;1708987;2015;50;54;2015
2973968;1464288;1509680;2015;55;59;2015
2503217;1216915;1286302;2015;60;64;2015
2351644;1117501;1234143;2015;65;69;2015
1943723;899501;1044222;2015;70;74;2015
1548157;670864;877293;2015;75;79;2015
1422651;571202;851449;2015;80;84;2015
1298439;425161;873278;2015;85;NA;2015
2192080;1129477;1062603;2016;0;4;2016
2470184;1274057;1196127;2016;5;9;2016
2335250;1199064;1136186;2016;10;14;2016
2179618;1122161;1057457;2016;15;19;2016
2283712;1165891;1117821;2016;20;24;2016
2578037;1293301;1284736;2016;25;29;2016
3121560;1567414;1554146;2016;30;34;2016
3864749;1965567;1899182;2016;35;39;2016
3929955;2004099;1925856;2016;40;44;2016
3711600;1874316;1837284;2016;45;49;2016
3456982;1722429;1734553;2016;50;54;2016
3068177;1510483;1557694;2016;55;59;2016
2562777;1245315;1317462;2016;60;64;2016
2340848;1113191;1227657;2016;65;69;2016
1968800;911420;1057380;2016;70;74;2016
1577308;687168;890140;2016;75;79;2016
1427204;575703;851501;2016;80;84;2016
1350043;445389;904654;2016;85;NA;2016
2138636;1101223;1037413;2017;0;4;2017
2448703;1262909;1185794;2017;5;9;2017
2382446;1224421;1158025;2017;10;14;2017
2213625;1139484;1074141;2017;15;19;2017
2261320;1154590;1106730;2017;20;24;2017
2532437;1273584;1258853;2017;25;29;2017
2987591;1495353;1492238;2017;30;34;2017
3739779;1896196;1843583;2017;35;39;2017
3970271;2022528;1947743;2017;40;44;2017
3742332;1890827;1851505;2017;45;49;2017
3520409;1755587;1764822;2017;50;54;2017
3145737;1548008;1597729;2017;55;59;2017
2629808;1277123;1352685;2017;60;64;2017
2362174;1124259;1237915;2017;65;69;2017
2047360;946033;1101327;2017;70;74;2017
1526402;669510;856892;2017;75;79;2017
1443451;581914;861537;2017;80;84;2017
1404912;467558;937354;2017;85;NA;2017
2093119;1077476;1015643;2018;0;4;2018
2415250;1245413;1169837;2018;5;9;2018
2432647;1250406;1182241;2018;10;14;2018
2251342;1159620;1091722;2018;15;19;2018
2260409;1154107;1106302;2018;20;24;2018
2525937;1272666;1253271;2018;25;29;2018
2884574;1441277;1443297;2018;30;34;2018
3609658;1822297;1787361;2018;35;39;2018
3988249;2029171;1959078;2018;40;44;2018
3770217;1906084;1864133;2018;45;49;2018
3589112;1789892;1799220;2018;50;54;2018
3199631;1574322;1625309;2018;55;59;2018
2706471;1312379;1394092;2018;60;64;2018
2397618;1142477;1255141;2018;65;69;2018
2117896;978115;1139781;2018;70;74;2018
1529583;674006;855577;2018;75;79;2018
1415774;571660;844114;2018;80;84;2018
1457583;488232;969351;2018;85;NA;2018
2051750;1055988;995762;2019;0;4;2019
2347303;1209616;1137687;2019;5;9;2019
2487814;1280218;1207596;2019;10;14;2019
2317402;1193170;1124232;2019;15;19;2019
2281187;1166267;1114920;2019;20;24;2019
2536089;1281017;1255072;2019;25;29;2019
2835775;1417507;1418268;2019;30;34;2019
3476449;1748816;1727633;2019;35;39;2019
4006919;2034885;1972034;2019;40;44;2019
3817465;1930721;1886744;2019;45;49;2019
3638022;1814172;1823850;2019;50;54;2019
3267118;1607423;1659695;2019;55;59;2019
2798735;1356407;1442328;2019;60;64;2019
2397492;1143117;1254375;2019;65;69;2019
2177047;1005912;1171135;2019;70;74;2019
1620072;716357;903715;2019;75;79;2019
1354983;547812;807171;2019;80;84;2019
1507329;507378;999951;2019;85;NA;2019
1997210;1027146;970064;2020;0;4;2020
2316951;1193800;1123151;2020;5;9;2020
2518203;1296566;1221637;2020;10;14;2020
2382307;1229004;1153303;2020;15;19;2020
2339329;1197324;1142005;2020;20;24;2020
2554056;1293715;1260341;2020;25;29;2020
2814068;1408703;1405365;2020;30;34;2020
3372562;1692447;1680115;2020;35;39;2020
3984935;2019123;1965812;2020;40;44;2020
3889302;1967103;1922199;2020;45;49;2020
3665371;1828801;1836570;2020;50;54;2020
3362147;1653869;1708278;2020;55;59;2020
2910171;1411151;1499020;2020;60;64;2020
2422118;1154405;1267713;2020;65;69;2020
2212376;1022060;1190316;2020;70;74;2020
1748837;775453;973384;2020;75;79;2020
1273151;514723;758428;2020;80;84;2020
1554956;525275;1029681;2020;85;NA;2020
1911907;982468;929439;2021;0;4;2021
2276513;1172526;1103987;2021;5;9;2021
2526248;1301408;1224840;2021;10;14;2021
2417282;1245262;1172020;2021;15;19;2021
2376512;1219260;1157252;2021;20;24;2021
2539851;1289224;1250627;2021;25;29;2021
2781659;1395728;1385931;2021;30;34;2021
3249877;1627523;1622354;2021;35;39;2021
3925856;1984798;1941058;2021;40;44;2021
3948606;1997773;1950833;2021;45;49;2021
3702259;1850118;1852141;2021;50;54;2021
3424428;1685039;1739389;2021;55;59;2021
3008316;1458727;1549589;2021;60;64;2021
2481683;1182036;1299647;2021;65;69;2021
2203067;1018228;1184839;2021;70;74;2021
1769658;784558;985100;2021;75;79;2021
1295191;526581;768610;2021;80;84;2021
1561885;527354;1034531;2021;85;NA;2021
1832027;941779;890248;2022;0;4;2022
2237522;1152040;1085482;2022;5;9;2022
2517973;1297537;1220436;2022;10;14;2022
2475545;1276388;1199157;2022;15;19;2022
2412235;1240995;1171240;2022;20;24;2022
2517989;1279911;1238078;2022;25;29;2022
2745317;1381778;1363539;2022;30;34;2022
3128161;1562778;1565383;2022;35;39;2022
3815001;1923736;1891265;2022;40;44;2022
3998277;2021465;1976812;2022;45;49;2022
3741798;1872186;1869612;2022;50;54;2022
3493906;1721655;1772251;2022;55;59;2022
3089284;1498642;1590642;2022;60;64;2022
2549654;1213745;1335909;2022;65;69;2022
2229420;1031421;1197999;2022;70;74;2022
1843837;816314;1027523;2022;75;79;2022
1258311;516026;742285;2022;80;84;2022
1600586;540401;1060185;2022;85;NA;2022
1786406;917887;868519;2023;0;4;2023
2221807;1143451;1078356;2023;5;9;2023
2529002;1303110;1225892;2023;10;14;2023
2562806;1321437;1241369;2023;15;19;2023
2502990;1289104;1213886;2023;20;24;2023
2573472;1308770;1264702;2023;25;29;2023
2799479;1410086;1389393;2023;30;34;2023
3085598;1537853;1547745;2023;35;39;2023
3739321;1876160;1863161;2023;40;44;2023
4055364;2046931;2008433;2023;45;49;2023
3800108;1901292;1898816;2023;50;54;2023
3583098;1764844;1818254;2023;55;59;2023
3158134;1531128;1627006;2023;60;64;2023
2631651;1250138;1381513;2023;65;69;2023
2271259;1051457;1219802;2023;70;74;2023
1913012;846418;1066594;2023;75;79;2023
1268777;523919;744858;2023;80;84;2023
1603077;541608;1061469;2023;85;NA;2023
1745534;896682;848852;2024;0;4;2024
2196171;1129681;1066490;2024;5;9;2024
2488672;1282236;1206436;2024;10;14;2024
2644868;1365911;1278957;2024;15;19;2024
2602761;1339587;1263174;2024;20;24;2024
2623628;1337669;1285959;2024;25;29;2024
2838400;1433634;1404766;2024;30;34;2024
3068799;1530503;1538296;2024;35;39;2024
3637955;1819465;1818490;2024;40;44;2024
4099619;2065486;2034133;2024;45;49;2024
3866761;1935652;1931109;2024;50;54;2024
3643908;1795185;1848723;2024;55;59;2024
3234251;1568711;1665540;2024;60;64;2024
2729694;1296776;1432918;2024;65;69;2024
2276017;1054644;1221373;2024;70;74;2024
1972223;873232;1098991;2024;75;79;2024
1353171;561655;791516;2024;80;84;2024
1597263;540162;1057101;2024;85;NA;2024
