"all";"male";"female";"year.ref";"age.min";"age.max";"year"
4006906;2047495;1959411;2010;0;4;2010
4043858;2069103;1974755;2010;5;9;2010
3956712;2027561;1929151;2010;10;14;2010
4014434;2052547;1961887;2010;15;19;2010
4033745;2027259;2006486;2010;20;24;2010
4019965;1983490;2036475;2010;25;29;2010
3933821;1945923;1987898;2010;30;34;2010
4512159;2241280;2270879;2010;35;39;2010
4508910;2230364;2278546;2010;40;44;2010
4507489;2214662;2292827;2010;45;49;2010
4299535;2095626;2203909;2010;50;54;2010
4205771;2043933;2161838;2010;55;59;2010
3876226;1879969;1996257;2010;60;64;2010
2611118;1239358;1371760;2010;65;69;2010
2464729;1109278;1355451;2010;70;74;2010
2293802;956651;1337151;2010;75;79;2010
1777155;664434;1112721;2010;80;84;2010
1592521;472831;1119690;2010;85;NA;2010
4027951;2060189;1967762;2011;0;4;2011
4028667;2060719;1967948;2011;5;9;2011
4012743;2055400;1957343;2011;10;14;2011
3980103;2036045;1944058;2011;15;19;2011
4017384;2021818;1995566;2011;20;24;2011
3984342;1963953;2020389;2011;25;29;2011
3993537;1972885;2020652;2011;30;34;2011
4418575;2195449;2223126;2011;35;39;2011
4502576;2228476;2274100;2011;40;44;2011
4530811;2227954;2302857;2011;45;49;2011
4324450;2112395;2212055;2011;50;54;2011
4172108;2022454;2149654;2011;55;59;2011
4108927;1989310;2119617;2011;60;64;2011
2684105;1275283;1408822;2011;65;69;2011
2431414;1101383;1330031;2011;70;74;2011
2269226;952762;1316464;2011;75;79;2011
1811011;683579;1127432;2011;80;84;2011
1680791;502848;1177943;2011;85;NA;2011
4020764;2053791;1966973;2012;0;4;2012
4054721;2074406;1980315;2012;5;9;2012
4054869;2076601;1978268;2012;10;14;2012
3925548;2008485;1917063;2012;15;19;2012
3987272;2007534;1979738;2012;20;24;2012
3963811;1955153;2008658;2012;25;29;2012
4068574;2005103;2063471;2012;30;34;2012
4285424;2126921;2158503;2012;35;39;2012
4519227;2238928;2280299;2012;40;44;2012
4551636;2241149;2310487;2012;45;49;2012
4350717;2125569;2225148;2012;50;54;2012
4182983;2024680;2158303;2012;55;59;2012
4123400;1991104;2132296;2012;60;64;2012
2968321;1411478;1556843;2012;65;69;2012
2372182;1080455;1291727;2012;70;74;2012
2254490;953023;1301467;2012;75;79;2012
1833898;700124;1133774;2012;80;84;2012
1759146;530879;1228267;2012;85;NA;2012
4017263;2054860;1962403;2013;0;4;2013
4079151;2087105;1992046;2013;5;9;2013
4096891;2098064;1998827;2013;10;14;2013
3911515;2001402;1910113;2013;15;19;2013
3957404;1995712;1961692;2013;20;24;2013
3931802;1939031;1992771;2013;25;29;2013
4118479;2025281;2093198;2013;30;34;2013
4169742;2067773;2101969;2013;35;39;2013
4566996;2265871;2301125;2013;40;44;2013
4548225;2240977;2307248;2013;45;49;2013
4371964;2138928;2233036;2013;50;54;2013
4184730;2026150;2158580;2013;55;59;2013
4121783;1983485;2138298;2013;60;64;2013
3234527;1537970;1696557;2013;65;69;2013
2371924;1087272;1284652;2013;70;74;2013
2229804;950157;1279647;2013;75;79;2013
1865947;718470;1147477;2013;80;84;2013
1822203;554157;1268046;2013;85;NA;2013
4026337;2058846;1967491;2014;0;4;2014
4148663;2121376;2027287;2014;5;9;2014
4151685;2125582;2026103;2014;10;14;2014
3976653;2034528;1942125;2014;15;19;2014
3903097;1970913;1932184;2014;20;24;2014
3969470;1954490;2014980;2014;25;29;2014
4143067;2032809;2110258;2014;30;34;2014
4087317;2023666;2063651;2014;35;39;2014
4596139;2282011;2314128;2014;40;44;2014
4535795;2234814;2300981;2014;45;49;2014
4431312;2169871;2261441;2014;50;54;2014
4212785;2039560;2173225;2014;55;59;2014
4098261;1967351;2130910;2014;60;64;2014
3483363;1656449;1826914;2014;65;69;2014
2404680;1108178;1296502;2014;70;74;2014
2230617;958108;1272509;2014;75;79;2014
1876052;727043;1149009;2014;80;84;2014
1890687;579534;1311153;2014;85;NA;2014
3994218;2038845;1955373;2015;0;4;2015
4175455;2136046;2039409;2015;5;9;2015
4176368;2135786;2040582;2015;10;14;2015
4021728;2059546;1962182;2015;15;19;2015
3837503;1938406;1899097;2015;20;24;2015
3968587;1953598;2014989;2015;25;29;2015
4146270;2029025;2117245;2015;30;34;2015
4053739;1999995;2053744;2015;35;39;2015
4558124;2261879;2296245;2015;40;44;2015
4508550;2224093;2284457;2015;45;49;2015
4466248;2188570;2277678;2015;50;54;2015
4233180;2047593;2185587;2015;55;59;2015
4083926;1957236;2126690;2015;60;64;2015
3711371;1763577;1947794;2015;65;69;2015
2447800;1131307;1316493;2015;70;74;2015
2218069;961353;1256716;2015;75;79;2015
1895559;741167;1154392;2015;80;84;2015
1961458;606236;1355222;2015;85;NA;2015
3931257;2006901;1924356;2016;0;4;2016
4196053;2145596;2050457;2016;5;9;2016
4156125;2125501;2030624;2016;10;14;2016
4077434;2088518;1988916;2016;15;19;2016
3785684;1913344;1872340;2016;20;24;2016
3951657;1945012;2006645;2016;25;29;2016
4101033;2003489;2097544;2016;30;34;2016
4110698;2021348;2089350;2016;35;39;2016
4458725;2209165;2249560;2016;40;44;2016
4496777;2219575;2277202;2016;45;49;2016
4489037;2201038;2287999;2016;50;54;2016
4259584;2061513;2198071;2016;55;59;2016
4057572;1940325;2117247;2016;60;64;2016
3939429;1868748;2070681;2016;65;69;2016
2521430;1166300;1355130;2016;70;74;2016
2195602;957857;1237745;2016;75;79;2016
1882143;741965;1140178;2016;80;84;2016
2028151;631191;1396960;2016;85;NA;2016
3879261;1980877;1898384;2017;0;4;2017
4176718;2134461;2042257;2017;5;9;2017
4165830;2128976;2036854;2017;10;14;2017
4103136;2106128;1997008;2017;15;19;2017
3752221;1894809;1857412;2017;20;24;2017
3910256;1928109;1982147;2017;25;29;2017
4078443;1985884;2092559;2017;30;34;2017
4184460;2053417;2131043;2017;35;39;2017
4326446;2139708;2186738;2017;40;44;2017
4505491;2228199;2277292;2017;45;49;2017
4497755;2205505;2292250;2017;50;54;2017
4275447;2073151;2202296;2017;55;59;2017
4066565;1940842;2125723;2017;60;64;2017
3953437;1873547;2079890;2017;65;69;2017
2785807;1290185;1495622;2017;70;74;2017
2144283;940334;1203949;2017;75;79;2017
1886429;750092;1136337;2017;80;84;2017
2117831;660128;1457703;2017;85;NA;2017
3818866;1947509;1871357;2018;0;4;2018
4176782;2134790;2041992;2018;5;9;2018
4183073;2138231;2044842;2018;10;14;2018
4142585;2127989;2014596;2018;15;19;2018
3728702;1884912;1843790;2018;20;24;2018
3885848;1919605;1966243;2018;25;29;2018
4059532;1973564;2085968;2018;30;34;2018
4239440;2074356;2165084;2018;35;39;2018
4214110;2081731;2132379;2018;40;44;2018
4546390;2248621;2297769;2018;45;49;2018
4497881;2207332;2290549;2018;50;54;2018
4292459;2082028;2210431;2018;55;59;2018
4067037;1938503;2128534;2018;60;64;2018
3948211;1865618;2082593;2018;65;69;2018
3037754;1408085;1629669;2018;70;74;2018
2146391;947571;1198820;2018;75;79;2018
1872278;751879;1120399;2018;80;84;2018
2168885;681906;1486979;2018;85;NA;2018
3749941;1913605;1836336;2019;0;4;2019
4150710;2121566;2029144;2019;5;9;2019
4213873;2156869;2057004;2019;10;14;2019
4182553;2149706;2032847;2019;15;19;2019
3772150;1912895;1859255;2019;20;24;2019
3813474;1888917;1924557;2019;25;29;2019
4079883;1983601;2096282;2019;30;34;2019
4250067;2072604;2177463;2019;35;39;2019
4126048;2035798;2090250;2019;40;44;2019
4574371;2262683;2311688;2019;45;49;2019
4477026;2199001;2278025;2019;50;54;2019
4344690;2109074;2235616;2019;55;59;2019
4090960;1949468;2141492;2019;60;64;2019
3923732;1848502;2075230;2019;65;69;2019
3270564;1516221;1754343;2019;70;74;2019
2182473;968146;1214327;2019;75;79;2019
1877724;761678;1116046;2019;80;84;2019
2210232;701005;1509227;2019;85;NA;2019
3683202;1883604;1799598;2020;0;4;2020
4124419;2106905;2017514;2020;5;9;2020
4231639;2166397;2065242;2020;10;14;2020
4183848;2152075;2031773;2020;15;19;2020
3800748;1930932;1869816;2020;20;24;2020
3771805;1870330;1901475;2020;25;29;2020
4092427;1991410;2101017;2020;30;34;2020
4251356;2070907;2180449;2020;35;39;2020
4096004;2014921;2081083;2020;40;44;2020
4535920;2245753;2290167;2020;45;49;2020
4446294;2184251;2262043;2020;50;54;2020
4387067;2131745;2255322;2020;55;59;2020
4122086;1966265;2155821;2020;60;64;2020
3913190;1840508;2072682;2020;65;69;2020
3486623;1614143;1872480;2020;70;74;2020
2217741;988502;1229239;2020;75;79;2020
1875096;766699;1108397;2020;80;84;2020
2254186;719634;1534552;2020;85;NA;2020
3618835;1849793;1769042;2021;0;4;2021
4075845;2082491;1993354;2021;5;9;2021
4273595;2188917;2084678;2021;10;14;2021
4160556;2140898;2019658;2021;15;19;2021
3868391;1968514;1899877;2021;20;24;2021
3762034;1865616;1896418;2021;25;29;2021
4111392;2009773;2101619;2021;30;34;2021
4235320;2062453;2172867;2021;35;39;2021
4172167;2047643;2124524;2021;40;44;2021
4459449;2207976;2251473;2021;45;49;2021
4448570;2188703;2259867;2021;50;54;2021
4420139;2151575;2268564;2021;55;59;2021
4152154;1985168;2166986;2021;60;64;2021
3890326;1822104;2068222;2021;65;69;2021
3699086;1710139;1988947;2021;70;74;2021
2280134;1017462;1262672;2021;75;79;2021
1843055;759539;1083516;2021;80;84;2021
2257520;723331;1534189;2021;85;NA;2021
3575218;1827260;1747958;2022;0;4;2022
4028449;2060903;1967546;2022;5;9;2022
4273827;2188364;2085463;2022;10;14;2022
4181454;2154258;2027196;2022;15;19;2022
3926056;2000306;1925750;2022;20;24;2022
3786823;1882803;1904020;2022;25;29;2022
4125645;2020880;2104765;2022;30;34;2022
4248626;2067336;2181290;2022;35;39;2022
4277620;2096203;2181417;2022;40;44;2022
4347593;2153572;2194021;2022;45;49;2022
4478052;2205180;2272872;2022;50;54;2022
4451374;2171273;2280101;2022;55;59;2022
4180619;2005365;2175254;2022;60;64;2022
3904936;1828073;2076863;2022;65;69;2022
3719823;1714584;2005239;2022;70;74;2022
2518634;1126482;1392152;2022;75;79;2022
1794190;744083;1050107;2022;80;84;2022
2272764;735701;1537063;2022;85;NA;2022
3522456;1801078;1721378;2023;0;4;2023
3955233;2024437;1930796;2023;5;9;2023
4279577;2191421;2088156;2023;10;14;2023
4211370;2171769;2039601;2023;15;19;2023
3957159;2016418;1940741;2023;20;24;2023
3796389;1891718;1904671;2023;25;29;2023
4123229;2024614;2098615;2023;30;34;2023
4242623;2063872;2178751;2023;35;39;2023
4338634;2122254;2216380;2023;40;44;2023
4241845;2099209;2142636;2023;45;49;2023
4523772;2230923;2292849;2023;50;54;2023
4456072;2176421;2279651;2023;55;59;2023
4202080;2019691;2182389;2023;60;64;2023
3904313;1829238;2075075;2023;65;69;2023
3715557;1706841;2008716;2023;70;74;2023
2745800;1229033;1516767;2023;75;79;2023
1791483;748047;1043436;2023;80;84;2023
2269618;741417;1528201;2023;85;NA;2023
3446636;1762357;1684279;2024;0;4;2024
3898842;1996946;1901896;2024;5;9;2024
4266020;2183474;2082546;2024;10;14;2024
4256949;2198009;2058940;2024;15;19;2024
3956031;2018613;1937418;2024;20;24;2024
3844224;1916642;1927582;2024;25;29;2024
4086649;2010938;2075711;2024;30;34;2024
4286489;2088059;2198430;2024;35;39;2024
4358205;2127607;2230598;2024;40;44;2024
4161310;2058109;2103201;2024;45;49;2024
4545641;2244232;2301409;2024;50;54;2024
4434603;2168745;2265858;2024;55;59;2024
4251469;2047369;2204100;2024;60;64;2024
3924072;1840554;2083518;2024;65;69;2024
3688991;1688502;2000489;2024;70;74;2024
2953908;1323611;1630297;2024;75;79;2024
1818923;765359;1053564;2024;80;84;2024
2288400;756953;1531447;2024;85;NA;2024
