"all";"male";"female";"year.ref";"age.min";"age.max";"year"
348445;178133;170312;2010;0;4;2010
310630;158962;151668;2010;5;9;2010
294200;151069;143131;2010;10;14;2010
289938;148194;141744;2010;15;19;2010
335288;163987;171301;2010;20;24;2010
390373;191173;199200;2010;25;29;2010
376630;187878;188752;2010;30;34;2010
357595;180165;177430;2010;35;39;2010
319721;161221;158500;2010;40;44;2010
299509;149536;149973;2010;45;49;2010
265827;133062;132765;2010;50;54;2010
238576;119942;118634;2010;55;59;2010
212380;106805;105575;2010;60;64;2010
161661;80578;81083;2010;65;69;2010
126904;61175;65729;2010;70;74;2010
98052;44609;53443;2010;75;79;2010
67725;26960;40765;2010;80;84;2010
55974;17525;38449;2010;85;NA;2010
360104;184043;176061;2011;0;4;2011
312884;160371;152513;2011;5;9;2011
299110;153437;145673;2011;10;14;2011
282000;144936;137064;2011;15;19;2011
306052;150981;155071;2011;20;24;2011
375490;180676;194814;2011;25;29;2011
387123;192639;194484;2011;30;34;2011
360873;181128;179745;2011;35;39;2011
326899;165109;161790;2011;40;44;2011
303340;151213;152127;2011;45;49;2011
271625;135723;135902;2011;50;54;2011
242213;121374;120839;2011;55;59;2011
216303;108611;107692;2011;60;64;2011
169883;84597;85286;2011;65;69;2011
129521;62732;66789;2011;70;74;2011
100260;45750;54510;2011;75;79;2011
68942;27790;41152;2011;80;84;2011
58259;18316;39943;2011;85;NA;2011
358152;182694;175458;2012;0;4;2012
323719;165589;158130;2012;5;9;2012
303964;155885;148079;2012;10;14;2012
281092;144056;137036;2012;15;19;2012
288296;143237;145059;2012;20;24;2012
346916;166364;180552;2012;25;29;2012
393954;193828;200126;2012;30;34;2012
364651;182167;182484;2012;35;39;2012
333240;167466;165774;2012;40;44;2012
306971;152603;154368;2012;45;49;2012
276790;137650;139140;2012;50;54;2012
247025;123375;123650;2012;55;59;2012
219002;109861;109141;2012;60;64;2012
179256;89352;89904;2012;65;69;2012
132476;64312;68164;2012;70;74;2012
103262;47405;55857;2012;75;79;2012
71088;29271;41817;2012;80;84;2012
59433;18884;40549;2012;85;NA;2012
354785;180777;174008;2013;0;4;2013
331793;169798;161995;2013;5;9;2013
306351;156834;149517;2013;10;14;2013
283640;145510;138130;2013;15;19;2013
280483;140392;140091;2013;20;24;2013
326669;156853;169816;2013;25;29;2013
392130;191381;200749;2013;30;34;2013
366363;182628;183735;2013;35;39;2013
339629;170281;169348;2013;40;44;2013
309419;153855;155564;2013;45;49;2013
281808;140302;141506;2013;50;54;2013
250151;124661;125490;2013;55;59;2013
222484;111191;111293;2013;60;64;2013
187723;93700;94023;2013;65;69;2013
137408;66781;70627;2013;70;74;2013
105538;48790;56748;2013;75;79;2013
72948;30556;42392;2013;80;84;2013
60457;19172;41285;2013;85;NA;2013
347769;177242;170527;2014;0;4;2014
340128;174011;166117;2014;5;9;2014
309118;157964;151154;2014;10;14;2014
289110;148461;140649;2014;15;19;2014
277122;139616;137506;2014;20;24;2014
309754;148881;160873;2014;25;29;2014
385021;186521;198500;2014;30;34;2014
370541;183487;187054;2014;35;39;2014
345449;172275;173174;2014;40;44;2014
311925;155718;156207;2014;45;49;2014
287617;142734;144883;2014;50;54;2014
254542;126693;127849;2014;55;59;2014
225516;112476;113040;2014;60;64;2014
195535;97680;97855;2014;65;69;2014
142932;69706;73226;2014;70;74;2014
108230;50138;58092;2014;75;79;2014
75505;32239;43266;2014;80;84;2014
62038;20008;42030;2014;85;NA;2014
340419;173576;166843;2015;0;4;2015
347408;177630;169778;2015;5;9;2015
313579;160489;153090;2015;10;14;2015
294505;151089;143416;2015;15;19;2015
275991;139870;136121;2015;20;24;2015
300545;144504;156041;2015;25;29;2015
372431;179055;193376;2015;30;34;2015
377485;185986;191499;2015;35;39;2015
351901;174532;177369;2015;40;44;2015
316059;157866;158193;2015;45;49;2015
293486;145386;148100;2015;50;54;2015
259193;128639;130554;2015;55;59;2015
229764;114561;115203;2015;60;64;2015
201997;100585;101412;2015;65;69;2015
149225;72771;76454;2015;70;74;2015
111281;51960;59321;2015;75;79;2015
77987;33667;44320;2015;80;84;2015
64371;21176;43195;2015;85;NA;2015
333134;170459;162675;2016;0;4;2016
353681;180507;173174;2016;5;9;2016
317689;162591;155098;2016;10;14;2016
3e+05;153801;146199;2016;15;19;2016
273996;138765;135231;2016;20;24;2016
297345;144916;152429;2016;25;29;2016
362424;173594;188830;2016;30;34;2016
386021;189560;196461;2016;35;39;2016
355742;176793;178949;2016;40;44;2016
323074;161492;161582;2016;45;49;2016
297660;147285;150375;2016;50;54;2016
266249;132142;134107;2016;55;59;2016
234752;116895;117857;2016;60;64;2016
206603;102670;103933;2016;65;69;2016
157500;77188;80312;2016;70;74;2016
113843;53204;60639;2016;75;79;2016
79946;34750;45196;2016;80;84;2016
66627;22529;44098;2016;85;NA;2016
328108;167898;160210;2017;0;4;2017
360348;183933;176415;2017;5;9;2017
323765;165829;157936;2017;10;14;2017
308058;157497;150561;2017;15;19;2017
277073;140852;136221;2017;20;24;2017
294894;145158;149736;2017;25;29;2017
352280;168421;183859;2017;30;34;2017
394414;192269;202145;2017;35;39;2017
362812;179742;183070;2017;40;44;2017
331769;165487;166282;2017;45;49;2017
302843;149770;153073;2017;50;54;2017
273413;135466;137947;2017;55;59;2017
241578;120095;121483;2017;60;64;2017
211443;104947;106496;2017;65;69;2017
168167;82579;85588;2017;70;74;2017
116412;54857;61555;2017;75;79;2017
82740;36121;46619;2017;80;84;2017
69040;24035;45005;2017;85;NA;2017
321429;164461;156968;2018;0;4;2018
359483;183622;175861;2018;5;9;2018
331383;169880;161503;2018;10;14;2018
314902;160335;154567;2018;15;19;2018
286727;146000;140727;2018;20;24;2018
291923;145503;146420;2018;25;29;2018
339626;162930;176696;2018;30;34;2018
397968;193032;204936;2018;35;39;2018
368140;181949;186191;2018;40;44;2018
340702;170169;170533;2018;45;49;2018
306890;151978;154912;2018;50;54;2018
279020;138105;140915;2018;55;59;2018
246350;122150;124200;2018;60;64;2018
216047;106960;109087;2018;65;69;2018
176927;86805;90122;2018;70;74;2018
121267;57457;63810;2018;75;79;2018
85108;37428;47680;2018;80;84;2018
71841;25626;46215;2018;85;NA;2018
316815;161993;154822;2019;0;4;2019
356814;182868;173946;2019;5;9;2019
342127;175487;166640;2019;10;14;2019
321199;163811;157388;2019;15;19;2019
299533;153305;146228;2019;20;24;2019
292185;146480;145705;2019;25;29;2019
334797;161272;173525;2019;30;34;2019
400014;192927;207087;2019;35;39;2019
378851;185893;192958;2019;40;44;2019
351103;174940;176163;2019;45;49;2019
311572;154717;156855;2019;50;54;2019
286217;141190;145027;2019;55;59;2019
253358;125452;127906;2019;60;64;2019
219916;108812;111104;2019;65;69;2019
184767;90508;94259;2019;70;74;2019
128775;61299;67476;2019;75;79;2019
87701;38882;48819;2019;80;84;2019
74567;26978;47589;2019;85;NA;2019
310956;159698;151258;2020;0;4;2020
351952;180344;171608;2020;5;9;2020
352772;180682;172090;2020;10;14;2020
326755;166027;160728;2020;15;19;2020
308997;157552;151445;2020;20;24;2020
294399;147020;147379;2020;25;29;2020
331441;160595;170846;2020;30;34;2020
391495;188783;202712;2020;35;39;2020
388881;190751;198130;2020;40;44;2020
360950;179478;181472;2020;45;49;2020
318384;158548;159836;2020;50;54;2020
294440;145229;149211;2020;55;59;2020
259782;128093;131689;2020;60;64;2020
225691;111536;114155;2020;65;69;2020
191520;93603;97917;2020;70;74;2020
137648;65232;72416;2020;75;79;2020
90422;40482;49940;2020;80;84;2020
76115;28059;48056;2020;85;NA;2020
303092;155236;147856;2021;0;4;2021
344897;177067;167830;2021;5;9;2021
362576;185067;177509;2021;10;14;2021
327734;166722;161012;2021;15;19;2021
310392;157535;152857;2021;20;24;2021
295043;147808;147235;2021;25;29;2021
331302;161171;170131;2021;30;34;2021
385102;185435;199667;2021;35;39;2021
401423;196802;204621;2021;40;44;2021
366729;182214;184515;2021;45;49;2021
327265;163489;163776;2021;50;54;2021
300091;148460;151631;2021;55;59;2021
267070;131929;135141;2021;60;64;2021
231159;113882;117277;2021;65;69;2021
195722;96046;99676;2021;70;74;2021
146601;69884;76717;2021;75;79;2021
92220;41487;50733;2021;80;84;2021
78475;28950;49525;2021;85;NA;2021
296694;151142;145552;2022;0;4;2022
344357;177189;167168;2022;5;9;2022
371447;189343;182104;2022;10;14;2022
333936;170163;163773;2022;15;19;2022
311012;158121;152891;2022;20;24;2022
298290;149493;148797;2022;25;29;2022
334108;161965;172143;2022;30;34;2022
384473;184634;199839;2022;35;39;2022
411364;200427;210937;2022;40;44;2022
373804;185953;187851;2022;45;49;2022
339388;169482;169906;2022;50;54;2022
307216;151963;155253;2022;55;59;2022
274960;136129;138831;2022;60;64;2022
238459;117704;120755;2022;65;69;2022
202709;99187;103522;2022;70;74;2022
152700;72920;79780;2022;75;79;2022
96016;43110;52906;2022;80;84;2022
83344;31307;52037;2022;85;NA;2022
298007;151676;146331;2023;0;4;2023
341967;175211;166756;2023;5;9;2023
379467;193916;185551;2023;10;14;2023
343539;176634;166905;2023;15;19;2023
314437;159913;154524;2023;20;24;2023
309559;154959;154600;2023;25;29;2023
339309;164757;174552;2023;30;34;2023
385962;184500;201462;2023;35;39;2023
425708;206541;219167;2023;40;44;2023
383883;189268;194615;2023;45;49;2023
350992;175134;175858;2023;50;54;2023
314883;155312;159571;2023;55;59;2023
283167;139320;143847;2023;60;64;2023
244141;120061;124080;2023;65;69;2023
208673;101842;106831;2023;70;74;2023
160558;76999;83559;2023;75;79;2023
100109;45427;54682;2023;80;84;2023
87034;33077;53957;2023;85;NA;2023
293631;149260;144371;2024;0;4;2024
338288;173143;165145;2024;5;9;2024
380824;195084;185740;2024;10;14;2024
355598;183781;171817;2024;15;19;2024
319584;163867;155717;2024;20;24;2024
316180;159096;157084;2024;25;29;2024
338111;164582;173529;2024;30;34;2024
383274;182787;200487;2024;35;39;2024
431629;208094;223535;2024;40;44;2024
391333;192203;199130;2024;45;49;2024
362443;179719;182724;2024;50;54;2024
320667;158211;162456;2024;55;59;2024
292810;143516;149294;2024;60;64;2024
250313;122782;127531;2024;65;69;2024
213704;104088;109616;2024;70;74;2024
167279;80192;87087;2024;75;79;2024
105484;48060;57424;2024;80;84;2024
90529;34910;55619;2024;85;NA;2024
