"all";"male";"female";"year.ref";"age.min";"age.max";"year"
513411;262493;250918;2010;0;4;2010
549205;281447;267758;2010;5;9;2010
555377;284370;271007;2010;10;14;2010
574258;292970;281288;2010;15;19;2010
591797;299195;292602;2010;20;24;2010
694667;344969;349698;2010;25;29;2010
806957;396956;410001;2010;30;34;2010
813892;398779;415113;2010;35;39;2010
775647;379027;396620;2010;40;44;2010
774901;375975;398926;2010;45;49;2010
713593;344096;369497;2010;50;54;2010
667204;318131;349073;2010;55;59;2010
612174;284884;327290;2010;60;64;2010
521732;236721;285011;2010;65;69;2010
497868;217854;280014;2010;70;74;2010
421069;173768;247301;2010;75;79;2010
283512;105620;177892;2010;80;84;2010
206215;66490;139725;2010;85;NA;2010
499554;255047;244507;2011;0;4;2011
532011;273423;258588;2011;5;9;2011
563608;288214;275394;2011;10;14;2011
567144;289407;277737;2011;15;19;2011
584024;294246;289778;2011;20;24;2011
662622;328394;334228;2011;25;29;2011
781969;382947;399022;2011;30;34;2011
827511;404751;422760;2011;35;39;2011
776647;379550;397097;2011;40;44;2011
780201;377868;402333;2011;45;49;2011
725500;350510;374990;2011;50;54;2011
674676;320909;353767;2011;55;59;2011
620832;290506;330326;2011;60;64;2011
536679;242817;293862;2011;65;69;2011
492639;216068;276571;2011;70;74;2011
428859;177446;251413;2011;75;79;2011
293074;109633;183441;2011;80;84;2011
225171;71807;153364;2011;85;NA;2011
494741;253015;241726;2012;0;4;2012
526703;270286;256417;2012;5;9;2012
560709;286701;274008;2012;10;14;2012
558449;285216;273233;2012;15;19;2012
578016;291603;286413;2012;20;24;2012
635925;315494;320431;2012;25;29;2012
747882;364878;383004;2012;30;34;2012
829990;404052;425938;2012;35;39;2012
779270;379955;399315;2012;40;44;2012
778047;375781;402266;2012;45;49;2012
735609;354152;381457;2012;50;54;2012
675375;320310;355065;2012;55;59;2012
633696;297715;335981;2012;60;64;2012
548611;247976;300635;2012;65;69;2012
480877;212031;268846;2012;70;74;2012
430384;179874;250510;2012;75;79;2012
311828;119595;192233;2012;80;84;2012
252838;79755;173083;2012;85;NA;2012
485165;248348;236817;2013;0;4;2013
517723;265560;252163;2013;5;9;2013
557118;285525;271593;2013;10;14;2013
551985;281933;270052;2013;15;19;2013
570446;287617;282829;2013;20;24;2013
605309;300987;304322;2013;25;29;2013
714701;347325;367376;2013;30;34;2013
825954;400748;425206;2013;35;39;2013
784602;381366;403236;2013;40;44;2013
773120;372399;400721;2013;45;49;2013
742214;356042;386172;2013;50;54;2013
679551;322276;357275;2013;55;59;2013
646758;303738;343020;2013;60;64;2013
558976;252659;306317;2013;65;69;2013
477043;210563;266480;2013;70;74;2013
430222;179917;250305;2013;75;79;2013
320635;123307;197328;2013;80;84;2013
262367;82984;179383;2013;85;NA;2013
466541;238563;227978;2014;0;4;2014
511837;262647;249190;2014;5;9;2014
552624;283442;269182;2014;10;14;2014
547284;279884;267400;2014;15;19;2014
562395;283583;278812;2014;20;24;2014
581043;289195;291848;2014;25;29;2014
688140;333994;354146;2014;30;34;2014
809698;391082;418616;2014;35;39;2014
789321;381878;407443;2014;40;44;2014
767351;369114;398237;2014;45;49;2014
747484;357533;389951;2014;50;54;2014
688338;325863;362475;2014;55;59;2014
644335;302475;341860;2014;60;64;2014
576221;260751;315470;2014;65;69;2014
477976;210847;267129;2014;70;74;2014
432940;181460;251480;2014;75;79;2014
325736;125848;199888;2014;80;84;2014
274828;87186;187642;2014;85;NA;2014
451569;231268;220301;2015;0;4;2015
504363;258595;245768;2015;5;9;2015
542413;278458;263955;2015;10;14;2015
551643;281799;269844;2015;15;19;2015
553280;279488;273792;2015;20;24;2015
559416;278801;280615;2015;25;29;2015
665173;322820;342353;2015;30;34;2015
785116;378118;406998;2015;35;39;2015
797884;384355;413529;2015;40;44;2015
758958;364646;394312;2015;45;49;2015
756461;360686;395775;2015;50;54;2015
694810;328311;366499;2015;55;59;2015
648575;303613;344962;2015;60;64;2015
587504;267723;319781;2015;65;69;2015
483847;213484;270363;2015;70;74;2015
436031;182718;253313;2015;75;79;2015
330528;128152;202376;2015;80;84;2015
287550;91633;195917;2015;85;NA;2015
436661;224047;212614;2016;0;4;2016
499029;254887;244142;2016;5;9;2016
531573;273104;258469;2016;10;14;2016
560042;286145;273897;2016;15;19;2016
546040;276357;269683;2016;20;24;2016
551466;275334;276132;2016;25;29;2016
637280;310183;327097;2016;30;34;2016
760185;364918;395267;2016;35;39;2016
806604;388003;418601;2016;40;44;2016
756632;363276;393356;2016;45;49;2016
758266;360597;397669;2016;50;54;2016
705053;333624;371429;2016;55;59;2016
654712;305631;349081;2016;60;64;2016
596549;273846;322703;2016;65;69;2016
499643;219830;279813;2016;70;74;2016
432734;182202;250532;2016;75;79;2016
337463;131481;205982;2016;80;84;2016
298622;96000;202622;2016;85;NA;2016
427131;219197;207934;2017;0;4;2017
493797;252496;241301;2017;5;9;2017
525896;269681;256215;2017;10;14;2017
558156;285434;272722;2017;15;19;2017
539439;273987;265452;2017;20;24;2017
547476;274446;273030;2017;25;29;2017
612647;299356;313291;2017;30;34;2017
729937;350165;379772;2017;35;39;2017
810450;389295;421155;2017;40;44;2017
760556;364956;395600;2017;45;49;2017
758019;360071;397948;2017;50;54;2017
717074;338799;378275;2017;55;59;2017
657448;306260;351188;2017;60;64;2017
611614;282257;329357;2017;65;69;2017
514075;226137;287938;2017;70;74;2017
426619;180103;246516;2017;75;79;2017
344067;134784;209283;2017;80;84;2017
310077;100512;209565;2017;85;NA;2017
423917;217161;206756;2018;0;4;2018
484843;248083;236760;2018;5;9;2018
517060;264746;252314;2018;10;14;2018
556157;284926;271231;2018;15;19;2018
537458;273194;264264;2018;20;24;2018
546782;274082;272700;2018;25;29;2018
589542;289062;300480;2018;30;34;2018
703974;337437;366537;2018;35;39;2018
810179;389139;421040;2018;40;44;2018
767809;368332;399477;2018;45;49;2018
755458;358388;397070;2018;50;54;2018
725210;341957;383253;2018;55;59;2018
665319;310380;354939;2018;60;64;2018
627359;289716;337643;2018;65;69;2018
528508;233581;294927;2018;70;74;2018
426552;181068;245484;2018;75;79;2018
347314;136533;210781;2018;80;84;2018
322329;104846;217483;2018;85;NA;2018
428513;219201;209312;2019;0;4;2019
467187;238601;228586;2019;5;9;2019
511239;261570;249669;2019;10;14;2019
552415;282820;269595;2019;15;19;2019
537661;273251;264410;2019;20;24;2019
545895;273146;272749;2019;25;29;2019
573673;281728;291945;2019;30;34;2019
685449;329243;356206;2019;35;39;2019
799141;383303;415838;2019;40;44;2019
774371;370735;403636;2019;45;49;2019
752612;357108;395504;2019;50;54;2019
731504;344264;387240;2019;55;59;2019
678018;316047;361971;2019;60;64;2019
629274;290896;338378;2019;65;69;2019
550437;244421;306016;2019;70;74;2019
430858;183775;247083;2019;75;79;2019
352972;139774;213198;2019;80;84;2019
332277;108731;223546;2019;85;NA;2019
433867;221764;212103;2020;0;4;2020
453849;232075;221774;2020;5;9;2020
504600;257509;247091;2020;10;14;2020
543199;278369;264830;2020;15;19;2020
547860;278887;268973;2020;20;24;2020
545779;274075;271704;2020;25;29;2020
563303;277652;285651;2020;30;34;2020
673005;324911;348094;2020;35;39;2020
783098;376779;406319;2020;40;44;2020
786195;376331;409864;2020;45;49;2020
748505;355853;392652;2020;50;54;2020
742769;349298;393471;2020;55;59;2020
690884;321863;369021;2020;60;64;2020
640844;296428;344416;2020;65;69;2020
570484;256360;314124;2020;70;74;2020
442781;190849;251932;2020;75;79;2020
360861;144287;216574;2020;80;84;2020
343512;113700;229812;2020;85;NA;2020
433732;221865;211867;2021;0;4;2021
440164;225547;214617;2021;5;9;2021
500161;254046;246115;2021;10;14;2021
532451;272956;259495;2021;15;19;2021
558899;284907;273992;2021;20;24;2021
543237;273955;269282;2021;25;29;2021
560694;277876;282818;2021;30;34;2021
651589;316284;335305;2021;35;39;2021
766131;368507;397624;2021;40;44;2021
797726;382134;415592;2021;45;49;2021
748365;356087;392278;2021;50;54;2021
745067;349716;395351;2021;55;59;2021
703828;328700;375128;2021;60;64;2021
651769;301143;350626;2021;65;69;2021
585038;265464;319574;2021;70;74;2021
461865;199544;262321;2021;75;79;2021
360855;146106;214749;2021;80;84;2021
352726;118034;234692;2021;85;NA;2021
426992;218686;208306;2022;0;4;2022
433175;222328;210847;2022;5;9;2022
497656;253406;244250;2022;10;14;2022
528895;270561;258334;2022;15;19;2022
560746;286456;274290;2022;20;24;2022
544830;276848;267982;2022;25;29;2022
564506;281937;282569;2022;30;34;2022
634615;310258;324357;2022;35;39;2022
743569;358468;385101;2022;40;44;2022
807123;387023;420100;2022;45;49;2022
753851;359343;394508;2022;50;54;2022
746862;350495;396367;2022;55;59;2022
716653;334647;382006;2022;60;64;2022
658158;303957;354201;2022;65;69;2022
603512;275742;327770;2022;70;74;2022
478962;207562;271400;2022;75;79;2022
358685;146785;211900;2022;80;84;2022
362327;122760;239567;2022;85;NA;2022
428501;219895;208606;2023;0;4;2023
437231;224265;212966;2023;5;9;2023
495740;253076;242664;2023;10;14;2023
525574;268327;257247;2023;15;19;2023
565378;289136;276242;2023;20;24;2023
555084;283434;271650;2023;25;29;2023
578434;290068;288366;2023;30;34;2023
625604;307340;318264;2023;35;39;2023
729857;352494;377363;2023;40;44;2023
818452;393300;425152;2023;45;49;2023
767932;366542;401390;2023;50;54;2023
750521;351904;398617;2023;55;59;2023
727409;339566;387843;2023;60;64;2023
669746;309736;360010;2023;65;69;2023
618759;282322;336437;2023;70;74;2023
494631;215355;279276;2023;75;79;2023
359261;148063;211198;2023;80;84;2023
368507;125825;242682;2023;85;NA;2023
429772;221121;208651;2024;0;4;2024
448180;229621;218559;2024;5;9;2024
485816;247542;238274;2024;10;14;2024
528106;269206;258900;2024;15;19;2024
570651;290561;280090;2024;20;24;2024
570426;291928;278498;2024;25;29;2024
595831;300061;295770;2024;30;34;2024
625728;308975;316753;2024;35;39;2024
725913;352038;373875;2024;40;44;2024
820461;394465;425996;2024;45;49;2024
782582;373346;409236;2024;50;54;2024
754885;354591;400294;2024;55;59;2024
736800;344026;392774;2024;60;64;2024
685297;316994;368303;2024;65;69;2024
619143;282121;337022;2024;70;74;2024
516919;225565;291354;2024;75;79;2024
363850;150497;213353;2024;80;84;2024
379366;130910;248456;2024;85;NA;2024
